NO textures/BRICK_3B.PNG


SO textures/BRICK_3D.PNG


WE textures/BRICK_2B.PNG


EA textures/BRICK_1A.PNG

C	75,190,75

F       108,255,51 
 
        11111111111111111111111
        100000000N110000000000001
        1111000001110000001000001
        100100000000000000100001
111111111011000001110000001000001
100000000011000001110111110111111
11110111111111011100000011001
11110111111111011101010010001
11000000110101011100000010001
1000000000000001100000011011
10000000000000001101010010001
1100000111010101111101111000111
11110111 1110101 101111010001
11111111 1111111 111111111111
