NO     textures/BRICK_1A.PNG


SO 		textures/CRATE_1D.PNG


WE textures/DOOR_1A.PNG


EA textures/BRICK_1A.PNG


C	135,206,255

F       222,184,135

        111111111111111111111111
        100000000110010000000001
         1000000011101010010001
         1010000000000100010001
11111111101100000110000001000011
1000000000110000N1110111110111111
100001110000011111011100000011001
111101111111110111010100100011111
11000000110101011100000010001
1000000000000001100000011011
10000000000000001101010010001
1100000111010101111101111000111
11110111 1110101 101111010001
11111111 1111111 111111111111